10
12
1 1 1 1 0 0 0 0 0 5
 2 0 0 3 0 0 0 0 5
4 4 4 4 3 0 2 0 0 5
 2 0 0 0 3 0 2 0 5
5 5 5 5 0 3 3 4 4 0